8 8
********
*      *
*    @S*
*      *
*   @  *
*   D  *
*      *
********