20 15
***************
*    @        *
*@          @ *
*    S        *
*             *
*    @    @   *
*             *
*             *
*             *
*    @@       *
*      @      *
*          @  *
*             *
*        @    *
*    @        *
*             *
*             *
*     D       *
*             *
***************