6 5
*****
*S  *
* @ *
* D@* 
*   *
*****