5 7
*******
*   D@*
*@  @ *
*  S  *
*******